#######################################
# Syntax Coloring Map For shButton
#######################################

#######################################
# Datatypes (KEYWORD1)
#######################################

shSimpleClock	KEYWORD1
clkDisplayMode	KEYWORD1
shSimpleRTC	KEYWORD1
clkButton	KEYWORD1
clkButtonGroup	KEYWORD1
clkDataType	KEYWORD1
clkButtonFlag	KEYWORD1

#######################################
# Methods and Functions (KEYWORD2) 
#######################################

init	KEYWORD2
tick	KEYWORD2
getDisplayMode	KEYWORD2
setDisplayMode	KEYWORD2
getButtonState	KEYWORD2
getButtonFlag	KEYWORD2
setButtonFlag	KEYWORD2
setMatrixDirection	KEYWORD2
setMatrixFlipMode	KEYWORD2
getCurrentDateTime	KEYWORD2
setCurrentTime	KEYWORD2
setCurrentDate	KEYWORD2
setCurrentYear	KEYWORD2
getTemperature	KEYWORD2
getAlarmPoint	KEYWORD2
setAlarmPoint	KEYWORD2
getOnOffAlarm	KEYWORD2
setOnOffAlarm	KEYWORD2
getAlarmState	KEYWORD2
buzzerStop	KEYWORD2
setColorOfNumber	KEYWORD2
getColorOfNumber	KEYWORD2
setColorOfBackground	KEYWORD2
setMaxPSP	KEYWORD2
getBrightnessMax	KEYWORD2
setBrightnessMax	KEYWORD2
getBrightnessMin	KEYWORD2
setBrightnessMin	KEYWORD2
setClockEvent	KEYWORD2
setAlarmEvent	KEYWORD2
setClockEventState	KEYWORD2
setAlarmEventState	KEYWORD2
getLightThresholdValue	KEYWORD2
setLightThresholdValue	KEYWORD2
setClockEventState	KEYWORD2
getAlarmEventState	KEYWORD2
setAnimationState	KEYWORD2
getAnimationState	KEYWORD2

#######################################
# Constants (LITERAL1)
#######################################

NO_TAG	LITERAL1
TICKER_TAG	LITERAL1
ALARM_TAG	LITERAL1
AUTO_SHOW_PERIOD_TAG	LITERAL1
SET_BRIGHTNESS_TAG	LITERAL1
SET_LIGHT_THRESHOLD_TAG	LITERAL1
SET_COLOR_OF_NUMBER_TAG	LITERAL1
DISPLAY_MODE_SHOW_TIME	LITERAL1
DISPLAY_MODE_SET_HOUR	LITERAL1
DISPLAY_MODE_SET_MINUTE	LITERAL1
DISPLAY_MODE_SET_DAY	LITERAL1
DISPLAY_MODE_SET_MONTH	LITERAL1
DISPLAY_MODE_SET_YEAR	LITERAL1
DISPLAY_MODE_ALARM_ON_OFF	LITERAL1
DISPLAY_MODE_SET_ALARM_HOUR	LITERAL1
DISPLAY_MODE_SET_ALARM_MINUTE	LITERAL1
DISPLAY_MODE_SHOW_TEMP	LITERAL1
DISPLAY_AUTO_SHOW_DATA	LITERAL1
DISPLAY_MODE_SHOW_DATE	LITERAL1
DISPLAY_MODE_SHOW_DOW	LITERAL1
DISPLAY_MODE_SHOW_DAY_AND_MONTH	LITERAL1
DISPLAY_MODE_SHOW_YEAR	LITERAL1
DISPLAY_MODE_SET_LIGHT_THRESHOLD	LITERAL1
DISPLAY_MODE_SET_BRIGHTNESS_MIN	LITERAL1
DISPLAY_MODE_SET_BRIGHTNESS_MAX	LITERAL1
DISPLAY_MODE_SET_TICKER_ON_OFF	LITERAL1
DISPLAY_MODE_SET_AUTO_SHOW_PERIOD	LITERAL1
DISPLAY_MODE_SET_COLOR_OF_NUMBER	LITERAL1
BTN_FLAG_NONE	LITERAL1
BTN_FLAG_NEXT	LITERAL1
BTN_FLAG_EXIT	LITERAL1
SSC_BTN_SET	LITERAL1
SSC_BTN_UP	LITERAL1
SSC_BTN_DOWN	LITERAL1
